1711111111122222222200000000000000000000000000000000000000000000000000000000000000000000000000000077
1711111111222222220000000000000000000000000000000000000000000000000000000000000000000000000000000077
1711111110000000000000000000000000000000000000000000000000000000000000000000000000000000000600000077
1711111000000000000000000000000000000000000000000000000000000000000000000000000000000060000000000077
1711110000000000000000000000000000000000000066600000000000000000000000000000000660000000000000000077
1711110000000000000000000000000000000066000888800000000000000000000000000000000770000000000000000077
1711100000000000000000000000000000006688000088850000000000000000000000000066000000000000000000000077
1711100000000000000000660000000000668888900088066600000000000000000000000088000000000000000000000077
1711100000000000000000770000000000888888999988555800000550000889999777799988999999999999999999900977
666666666667766666666666666898666666666666666666666666666666666666666666666666666666666666666666666