0700000000000000000000000000000000000000000000000000000000000000000000000000000000000000000000000077
0700000000000000000000000000000000000000000000000000000000000000000000000000000000000000000000000077
0700000000000000000000000000000000000000000000000000000000000000000000000000000000000000000000000077
0700000000000000000000000000000000000000000000000000000000000000000000000000000000000000000000000077
0700000000000000000000000000000000000000000000330000000000000000000000000000000000000000000000000077
0700000000000000000000000000000000000660000000440000000000000000000000000000000000000000000000000077
0700000000000000000000000000000000006776000000000000000003300000000000000000000000000000000000000077
0700000000000000000000000000000000067007600000000000000335500000000000000000000000000000000000000077
0700000000000000000000000000000000674444760000000000000555566000000000000000000000000000000000000977
777777777777777777777777777777777777777777777777777777777777777777777777777777777777777777777777777